1	1	1	1	1	1	1	1	1	1	1	2	2	2	2	2	2	2	2	2	2	2	3	3	3	3	3	3	3	3	3	3	3	1	1	1	1	1	1	1	1	1	1	1	1	1	1	1	1	1	1	1	1	1	1	1	1	1	1	1	1	1	1	1	1	1	1	1	1	1	1	1	1	1	1	1	1	1	1	1	1	1	1	1	1	1	1	1	1	1	1	1	1	1	1	1	1	1	1	1
1	0	0	0	0	0	0	0	0	0	1	2	0	0	0	0	0	0	0	0	0	2	3	0	0	0	0	0	0	0	0	0	3	-25	0	0	0	0	0	0	0	0	0	0	0	0	3	4	0	0	0	0	0	-1	-1	5	5	5	5	5	5	5	5	6	6	6	6	6	6	6	6	6	6	6	6	6	6	6	0	0	0	0	0	0	0	0	0	0	0	0	0	0	0	0	0	0	0	0	0	1
1	0	0	0	0	0	0	0	0	0	1	2	0	0	0	0	0	0	0	0	0	2	3	0	0	0	0	0	0	0	0	0	3	-25	0	0	0	0	0	0	0	88	0	0	0	0	146	147	0	0	0	0	0	-1	-1	5	0	0	0	0	0	0	0	0	0	6	6	0	0	0	0	0	0	0	0	0	0	6	0	0	0	0	0	0	0	0	0	0	0	0	0	0	0	0	0	0	0	0	0	1
1	0	0	0	0	0	0	0	0	0	100	101	0	0	0	0	0	0	0	0	0	2	3	0	0	0	0	0	0	0	0	0	3	0	144	145	0	0	90	0	0	0	0	0	0	0	0	-26	0	0	0	0	0	-1	-1	5	-29	152	153	90	91	90	0	0	0	6	6	0	0	0	98	0	0	0	0	0	0	6	0	0	0	0	0	0	0	0	0	0	0	0	0	0	0	0	0	0	0	0	0	1
1	0	0	0	0	0	0	0	0	0	-3	-3	0	0	0	0	2	0	0	0	0	0	0	0	0	0	3	0	0	0	0	0	3	0	0	0	0	87	0	0	0	0	0	0	0	0	0	-26	0	0	0	0	0	-1	-1	5	0	0	0	-1	-1	-1	5	6	0	6	6	0	0	0	0	0	0	0	0	0	0	6	0	0	0	0	0	0	0	0	0	0	0	0	0	0	0	0	0	0	0	0	0	1
1	0	0	0	0	0	0	0	0	0	-3	-3	0	0	0	0	2	0	0	0	0	0	0	0	0	0	3	0	0	0	0	-1	3	0	0	0	0	0	0	0	87	0	89	0	0	0	3	4	87	0	0	0	88	-1	-1	5	0	0	0	0	0	0	5	6	0	6	6	0	0	0	0	0	0	0	0	0	0	6	0	0	0	0	0	0	0	0	0	0	0	0	0	0	0	0	0	0	0	0	0	1
1	121	100	1	1	1	1	1	1	1	1	2	2	2	2	2	2	2	2	2	2	2	3	3	3	3	3	0	0	3	3	3	3	0	0	0	0	0	0	0	0	0	0	0	0	0	3	4	-1	-1	-1	-1	0	-1	-1	5	5	0	0	0	0	0	5	6	0	6	6	0	0	0	0	0	0	0	0	0	0	6	0	0	0	0	0	0	0	0	0	0	0	0	0	0	0	0	0	0	0	0	0	1
6	6	6	6	6	6	6	6	6	6	6	5	5	5	5	5	5	5	5	5	5	5	4	4	4	4	4	-4	-4	4	4	4	4	0	0	0	0	0	0	0	0	0	0	0	0	0	3	4	-1	-1	-1	-1	0	-1	-1	5	0	0	0	0	0	0	5	6	0	6	6	0	0	0	0	0	0	0	0	96	92	6	0	0	0	0	0	0	0	0	0	0	0	0	0	0	0	0	0	0	0	0	0	1
6	0	0	0	0	0	0	0	0	0	6	5	0	0	5	0	0	0	5	0	0	0	0	0	0	0	0	0	0	0	0	0	4	89	0	0	0	0	-1	0	-1	0	0	0	0	0	3	4	0	0	0	0	0	-1	-1	5	0	91	0	0	0	0	5	6	0	6	6	0	0	0	0	0	0	0	0	0	0	6	0	0	0	0	0	0	0	0	0	0	0	0	0	0	0	0	0	0	0	0	0	1
6	0	0	0	0	0	0	0	0	0	6	5	0	0	5	0	0	0	5	0	0	0	0	0	0	0	0	0	0	0	0	0	4	0	0	0	0	0	0	0	0	-1	0	0	0	0	3	4	91	90	91	90	91	-1	-1	5	0	0	0	0	0	0	5	6	0	6	6	0	0	0	0	0	0	0	0	0	0	6	0	0	0	0	0	0	0	0	0	0	0	0	0	0	0	0	0	0	0	0	0	1
6	0	0	0	0	0	0	0	0	0	104	105	0	0	0	0	5	0	5	0	0	5	4	0	0	0	0	0	0	0	0	0	4	0	0	0	0	0	0	0	0	0	0	0	0	0	3	4	0	-1	-1	-1	-1	-1	-1	5	0	0	90	0	0	0	5	6	0	0	-30	0	0	0	0	0	0	0	0	0	0	6	0	0	0	0	0	0	0	0	0	0	0	0	0	0	0	0	0	0	0	0	0	1
6	0	0	0	0	0	0	0	0	0	-5	-5	0	0	0	0	5	0	5	0	0	5	4	0	0	0	0	0	0	0	0	0	4	0	0	0	0	0	0	-1	0	0	0	0	0	0	3	4	0	0	0	0	0	-1	-1	5	0	0	0	0	0	0	5	6	0	0	-30	0	0	0	0	0	0	0	0	0	0	6	0	0	0	0	0	0	0	0	0	0	0	0	0	0	0	0	0	0	0	0	0	1
6	0	0	0	0	0	0	0	0	0	-5	-5	0	0	5	-1	5	0	0	0	0	5	4	0	0	0	0	0	0	0	0	0	4	0	0	0	0	0	0	-1	0	0	0	143	0	0	3	4	0	0	0	0	0	0	-1	5	0	0	0	91	0	0	150	6	6	154	155	97	0	0	0	0	0	0	0	0	0	6	0	0	0	0	0	0	0	0	0	0	0	0	0	0	0	0	0	0	0	0	0	1
6	0	0	6	6	6	6	6	6	6	6	5	5	5	5	5	5	5	5	5	5	5	4	4	4	4	4	102	103	4	4	4	4	3	3	3	3	94	3	3	3	0	-24	142	0	0	3	4	4	93	0	0	0	92	-1	5	0	0	0	0	0	-28	151	0	0	0	6	0	0	0	0	0	0	0	0	0	0	6	0	0	0	0	0	0	0	0	0	0	0	0	0	0	0	0	0	0	0	0	0	1
1	-6	-6	1	0	0	0	0	0	0	0	0	0	0	0	0	0	0	1	2	2	2	2	2	2	2	2	3	0	0	0	0	0	0	0	0	0	0	0	0	3	0	3	3	0	0	3	4	0	0	0	0	0	-1	-1	5	-1	-1	0	0	90	0	5	0	0	0	6	0	0	0	0	0	0	0	0	0	0	6	0	0	0	0	0	0	0	0	0	0	0	0	0	0	0	0	0	0	0	0	0	1
1	0	0	1	0	0	0	0	0	0	0	0	0	0	0	0	0	0	1	2	-1	-1	-1	-1	2	2	2	3	0	0	0	0	0	0	98	0	0	0	0	0	3	0	0	0	0	0	3	4	0	0	0	0	0	-1	-1	5	0	0	0	0	0	0	5	0	0	0	6	0	0	0	0	0	0	0	0	0	0	6	0	0	0	0	0	0	0	0	0	0	0	0	0	0	0	0	0	0	0	0	0	1
1	0	0	1	0	0	98	97	0	0	0	0	98	0	0	0	0	0	1	2	0	-1	-1	-1	2	2	2	3	98	0	0	0	0	0	0	97	0	0	0	0	3	0	0	0	0	0	3	4	0	0	0	0	0	-1	148	149	0	0	0	91	0	0	5	0	0	0	6	-1	-1	-1	-1	-31	-1	-1	-1	-1	-1	6	0	0	0	0	0	0	0	0	0	0	0	0	0	0	0	0	0	0	0	0	0	1
1	0	0	1	0	0	0	0	0	0	0	0	0	0	0	0	0	0	1	2	0	0	0	0	2	2	2	3	0	0	0	0	0	0	0	0	0	0	0	0	3	0	0	0	0	0	3	4	0	0	0	0	0	0	0	-27	0	0	0	0	0	0	5	0	0	0	6	6	6	-1	0	0	0	-1	6	6	6	6	0	0	0	0	0	0	0	0	0	0	0	0	0	0	0	0	0	0	0	0	0	1
1	0	0	1	0	0	0	0	0	0	0	0	0	0	0	0	0	0	108	109	0	0	0	0	0	0	2	3	0	0	97	0	0	0	0	0	0	0	0	0	3	99	98	0	0	0	3	4	0	0	87	0	0	0	0	-27	0	0	90	0	0	0	5	0	0	0	0	0	1	-1	0	156	0	-1	1	0	0	0	0	0	0	0	0	0	0	0	0	0	0	0	0	0	0	0	0	0	0	0	0	1
1	0	0	1	0	0	0	0	0	0	0	0	0	0	0	0	0	0	-7	-7	0	0	0	0	0	0	110	111	0	0	0	0	0	0	0	0	0	0	0	0	3	0	0	0	0	0	3	4	-1	-1	-1	-1	-1	-1	4	5	0	0	0	0	0	-1	5	0	0	0	0	0	1	-1	0	157	0	-1	1	0	0	0	0	0	0	0	0	0	0	0	0	0	0	0	0	0	0	0	0	0	0	0	0	1
1	0	0	1	0	0	0	0	0	0	0	0	0	0	0	0	0	0	-7	-7	0	0	0	0	2	0	0	-8	0	0	0	0	0	0	0	0	0	0	0	0	3	0	0	0	0	0	3	4	4	4	4	4	4	4	4	5	5	5	5	5	5	5	5	0	0	0	0	0	1	-1	0	0	0	-1	1	0	0	0	0	0	0	0	0	0	0	0	0	0	0	0	0	0	0	0	0	0	0	0	0	1
1	0	0	1	0	0	0	0	0	0	0	0	97	0	0	0	0	1	1	2	0	0	0	-1	2	0	0	-8	0	0	0	0	0	0	0	0	0	0	0	0	3	0	0	0	0	0	3	3	3	2	2	2	2	2	2	2	2	2	2	2	2	0	0	0	0	0	0	0	1	-1	0	0	0	-1	1	0	0	0	0	0	0	0	0	0	0	0	0	0	0	0	0	0	0	0	0	0	0	0	0	1
1	0	0	0	0	0	0	0	0	0	0	0	0	0	0	0	0	0	1	2	0	2	2	2	2	0	0	-8	0	0	0	0	0	0	0	0	0	0	0	0	3	0	0	0	0	0	0	0	0	98	0	0	0	98	0	0	0	0	0	0	2	0	0	0	0	0	0	0	1	-1	0	0	0	-1	1	0	0	0	0	0	0	0	0	0	0	0	0	0	0	0	0	0	0	0	0	0	0	0	0	1
1	0	0	0	0	0	0	0	0	0	0	0	0	0	0	0	0	0	1	2	-1	-1	2	2	2	0	0	-1	0	0	0	0	0	0	0	0	0	0	0	0	3	0	0	0	0	0	0	0	0	0	0	88	0	0	88	0	0	88	0	-23	2	0	0	0	0	0	0	0	1	-1	0	0	0	-1	1	0	0	0	0	0	0	0	0	0	0	0	0	0	0	0	0	0	0	0	0	0	0	0	0	1
1	106	107	1	1	1	1	99	1	1	1	1	1	1	1	1	1	1	132	133	2	2	2	2	2	2	2	3	3	99	0	0	0	0	0	0	0	0	0	96	3	0	0	0	86	0	0	0	0	0	0	0	0	0	0	0	0	0	0	0	2	0	0	0	0	0	0	0	1	-1	-1	0	-1	-1	1	0	0	0	0	0	0	0	0	0	0	0	0	0	0	0	0	0	0	0	0	0	0	0	0	1
3	0	0	0	125	0	1	-1	1	1	1	1	1	1	1	1	-1	0	-19	0	0	0	0	0	0	0	0	0	3	-1	-1	-1	-1	-1	-1	-1	-1	0	-1	-1	3	0	0	0	0	0	0	0	0	0	0	0	0	0	0	0	0	0	0	0	141	0	0	0	0	0	0	0	1	-1	0	0	0	-1	1	0	0	0	0	0	0	0	0	0	0	0	0	0	0	0	0	0	0	0	0	0	0	0	0	1
3	0	0	0	124	0	1	1	1	0	0	0	0	0	0	-1	0	0	-19	0	0	0	0	0	0	0	0	0	3	3	3	3	3	3	3	3	3	0	3	3	3	99	0	0	0	0	0	0	0	90	89	0	99	0	0	89	99	0	0	0	140	0	0	0	0	0	0	0	1	-1	0	0	0	-1	1	0	0	0	0	0	0	0	0	0	0	0	0	0	0	0	0	0	0	0	0	0	0	0	0	1
3	0	0	0	-15	0	0	0	3	0	0	0	0	0	0	0	98	1	-19	0	0	0	0	0	0	0	0	0	3	3	3	3	3	3	3	4	4	-9	4	-1	-1	0	0	0	0	0	0	0	94	1	1	1	1	1	1	1	1	1	1	0	1	0	0	0	0	0	0	0	1	-1	0	0	0	-1	1	0	0	0	0	0	0	0	0	0	0	0	0	0	0	0	0	0	0	0	0	0	0	0	0	1
3	0	0	0	-15	0	0	0	3	0	0	0	0	0	0	96	0	1	-19	91	0	90	0	91	0	90	0	91	3	0	0	0	90	0	0	136	4	0	4	-1	-1	-1	-1	-1	-1	-1	-1	-1	-1	1	0	0	0	0	0	0	0	0	0	0	1	0	0	0	0	0	0	0	1	-1	0	0	0	-1	1	0	0	0	0	0	0	0	0	0	0	0	0	0	0	0	0	0	0	0	0	0	0	0	0	1
3	0	0	0	-15	0	0	0	130	-18	0	0	93	0	0	0	0	1	-19	0	0	0	0	0	0	0	0	0	3	0	0	0	90	0	0	137	4	0	4	-1	-1	-1	-1	-1	-1	-1	-1	-1	-1	1	0	0	0	0	0	0	0	0	0	0	1	0	0	0	0	0	0	0	1	-1	0	0	0	-1	1	0	0	0	0	0	0	0	0	0	0	0	0	0	0	0	0	0	0	0	0	0	0	0	0	1
3	0	0	0	-1	-1	0	0	131	0	0	0	0	0	0	0	0	1	-1	-1	-1	-1	-1	-1	0	0	-1	-1	3	0	0	0	90	0	0	-21	4	0	4	4	4	4	4	4	4	4	4	4	4	1	0	0	0	87	0	0	0	0	1	89	1	0	0	0	0	0	0	0	1	-1	0	0	0	-1	1	0	0	0	0	0	0	0	0	0	0	0	0	0	0	0	0	0	0	0	0	0	0	0	0	1
3	0	0	0	-1	-1	0	0	3	0	0	0	0	0	0	0	0	1	0	0	0	0	0	-1	0	0	0	-1	0	0	0	0	90	0	0	-21	0	0	0	0	0	0	0	0	0	0	0	0	138	139	0	0	0	0	0	0	0	0	0	0	1	0	0	0	0	0	0	0	1	-1	0	0	0	-1	1	0	0	0	0	0	0	0	0	0	0	0	0	0	0	0	0	0	0	0	0	0	0	0	0	1
3	-14	-14	122	123	3	0	0	3	0	0	0	0	0	0	0	0	1	0	0	0	0	0	0	-1	0	0	-1	0	0	0	0	0	0	4	4	0	0	0	0	0	0	0	0	0	0	0	0	-22	-22	0	0	0	0	0	0	0	0	0	0	1	0	0	0	0	0	0	0	1	-1	0	-1	-1	-1	1	0	0	0	0	0	0	0	0	0	0	0	0	0	0	0	0	0	0	0	0	0	0	0	0	1
2	0	0	2	2	2	0	0	3	0	0	0	0	0	0	0	0	1	0	0	0	0	0	0	-1	0	0	-20	0	0	0	0	0	0	0	4	0	112	0	0	98	0	97	0	0	0	0	0	-22	-22	0	0	0	0	0	0	0	0	0	-1	1	0	0	0	0	0	0	0	1	-1	0	0	0	-1	1	0	0	0	0	0	0	0	0	0	0	0	0	0	0	0	0	0	0	0	0	0	0	0	0	1
2	0	0	0	0	2	0	0	3	99	0	0	0	0	0	0	0	1	0	0	0	0	0	0	-1	0	0	-20	0	0	99	0	0	0	0	4	0	113	0	0	0	0	0	0	0	0	0	0	4	1	1	89	1	1	1	1	1	1	1	1	1	0	0	0	0	0	0	0	1	-1	0	0	0	-1	1	0	0	0	0	0	0	0	0	0	0	0	0	0	0	0	0	0	0	0	0	0	0	0	0	1
2	0	0	0	0	2	0	0	3	0	0	0	0	0	0	0	0	1	0	0	0	0	0	0	-1	0	0	-20	0	0	0	0	0	0	-1	4	0	0	0	0	0	0	0	0	0	0	0	0	4	0	0	-1	0	0	0	0	0	0	0	0	0	0	0	0	0	0	0	0	1	-1	0	0	0	-1	1	0	0	0	0	0	0	0	0	0	0	0	0	0	0	0	0	0	0	0	0	0	0	0	0	1
2	99	98	0	0	2	0	0	3	0	0	98	0	0	-1	-1	-1	1	0	0	0	0	0	0	-1	0	0	134	135	6	6	6	6	6	6	4	4	0	0	0	0	0	0	96	0	0	0	0	4	0	0	0	0	0	0	0	0	0	0	0	0	0	0	0	0	0	0	0	1	-1	0	0	0	-1	1	0	0	0	0	0	0	0	0	0	0	0	0	0	0	0	0	0	0	0	0	0	0	0	0	1
2	0	0	0	0	2	0	-1	3	0	0	0	0	0	1	1	1	1	0	0	0	0	0	0	-1	6	0	6	0	0	0	0	0	0	0	0	4	0	0	99	0	0	0	0	0	0	0	0	4	0	0	0	0	0	0	0	0	0	0	0	0	0	0	0	0	0	0	0	1	-1	0	0	0	-1	1	0	0	0	0	0	0	0	0	0	0	0	0	0	0	0	0	0	0	0	0	0	0	0	0	1
2	0	0	0	0	2	0	0	3	0	0	0	0	0	0	-17	128	1	0	0	0	0	0	0	-1	-1	-1	6	0	0	0	0	0	0	0	0	4	0	0	0	0	0	0	0	0	0	0	0	4	0	0	0	0	0	0	0	0	0	0	0	0	0	0	0	0	0	0	0	1	-1	0	0	0	-1	1	0	0	0	0	0	0	0	0	0	0	0	0	0	0	0	0	0	0	0	0	0	0	0	0	1
2	0	0	0	0	2	0	0	3	0	0	0	0	0	96	98	129	1	0	0	0	0	0	0	-1	-1	-1	6	0	0	0	0	0	96	98	0	4	0	0	0	0	0	0	0	0	0	0	0	4	0	0	0	0	0	0	0	0	0	0	0	0	0	0	0	0	0	0	0	1	-1	0	0	0	-1	1	0	0	0	0	0	0	0	0	0	0	0	0	0	0	0	0	0	0	0	0	0	0	0	0	1
2	0	0	0	0	2	0	0	3	0	0	0	0	0	0	0	1	1	1	1	6	6	6	6	6	6	6	6	0	0	0	0	0	0	0	0	4	4	4	4	4	4	4	4	4	4	0	0	4	0	0	0	0	0	0	0	0	0	0	0	0	0	0	0	0	0	0	0	1	-1	0	0	0	-1	1	0	0	0	0	0	0	0	0	0	0	0	0	0	0	0	0	0	0	0	0	0	0	0	0	1
2	0	0	0	0	2	0	0	3	0	0	0	0	0	0	0	1	0	0	-12	-12	0	0	0	0	0	0	0	0	0	0	0	0	0	0	0	0	116	117	5	5	5	5	5	5	5	-10	-10	5	0	0	0	0	0	0	0	0	0	0	0	0	0	0	0	0	0	0	0	1	-1	0	0	0	-1	1	0	0	0	0	0	0	0	0	0	0	0	0	0	0	0	0	0	0	0	0	0	0	0	0	1
2	0	0	0	0	2	0	0	3	0	0	0	0	0	0	0	1	0	0	-12	-12	0	0	0	0	0	0	0	0	0	0	0	0	0	0	0	0	-11	-11	0	0	0	0	5	5	5	0	0	5	0	0	0	0	0	0	0	0	0	0	0	0	0	0	0	0	0	0	0	1	-1	0	0	0	-1	1	0	0	0	0	0	0	0	0	0	0	0	0	0	0	0	0	0	0	0	0	0	0	0	0	1
2	0	0	0	0	2	0	0	3	0	0	0	0	0	0	0	1	0	0	118	119	93	0	0	0	0	0	0	0	92	0	0	0	0	0	0	0	-11	-11	0	0	0	0	5	5	5	0	0	5	0	0	0	0	0	0	0	0	0	0	0	0	0	0	0	0	0	0	0	1	-1	-1	-1	0	-1	1	0	0	0	0	0	0	0	0	0	0	0	0	0	0	0	0	0	0	0	0	0	0	0	0	1
2	99	98	0	0	2	0	0	126	0	0	0	0	0	0	0	1	0	0	1	6	0	0	0	0	0	0	0	0	0	0	0	0	0	0	0	92	6	5	0	0	0	0	5	5	5	0	0	5	1	1	1	1	1	1	1	1	1	1	1	1	1	1	1	1	1	1	1	1	-1	0	0	0	-1	1	0	0	0	0	0	0	0	0	0	0	0	0	0	0	0	0	0	0	0	0	0	0	0	0	1
2	0	0	0	0	2	-1	0	127	0	0	0	0	0	0	0	1	0	0	1	6	0	0	0	0	0	0	0	0	0	0	0	0	0	0	0	0	6	5	0	0	0	0	5	5	5	0	0	5	-1	-2	0	0	0	0	0	0	0	0	0	0	0	0	0	0	0	0	0	1	-1	0	0	0	-1	1	0	0	0	0	0	0	0	0	0	0	0	0	0	0	0	0	0	0	0	0	0	0	0	0	1
2	0	0	0	0	2	0	0	-16	0	0	0	0	0	0	0	1	0	0	1	6	0	0	0	0	0	0	0	0	0	0	0	0	0	0	0	0	6	5	0	0	0	0	5	5	5	0	0	5	-1	0	0	0	0	0	0	0	0	0	0	0	0	0	0	0	0	0	0	1	-1	0	0	0	-1	1	0	0	0	0	0	0	0	0	0	0	0	0	0	0	0	0	0	0	0	0	0	0	0	0	1
2	0	0	0	0	2	0	0	-16	0	0	0	0	0	0	-1	1	0	0	1	6	0	0	0	0	0	0	0	98	95	0	0	0	0	0	0	0	6	5	0	0	0	0	5	5	5	0	0	5	-1	0	0	0	0	0	0	0	0	0	0	0	0	0	0	0	0	0	0	1	-1	0	0	0	-1	1	0	0	0	0	0	0	0	0	0	0	0	0	0	0	0	0	0	0	0	0	0	0	0	0	1
2	0	0	0	0	2	3	3	3	95	4	4	4	4	4	4	1	0	0	1	6	0	0	0	0	0	0	0	0	0	0	0	0	0	0	98	99	6	5	0	99	0	0	5	5	5	0	0	5	-1	0	0	-1	0	0	0	0	0	0	0	0	0	0	0	0	0	0	0	1	-1	0	0	0	-1	1	0	0	0	0	0	0	0	0	0	0	0	0	0	0	0	0	0	0	0	0	0	0	0	0	1
2	0	0	0	0	2	1	1	1	-1	1	1	1	1	1	1	1	0	0	1	6	0	0	0	0	0	0	0	0	0	0	0	0	0	0	0	0	6	5	0	0	0	0	0	5	5	0	0	5	-1	0	0	0	0	96	0	0	0	0	0	0	0	0	0	0	0	0	0	1	-1	0	0	0	-1	1	0	0	0	0	0	0	0	0	0	0	0	0	0	0	0	0	0	0	0	0	0	0	0	0	1
2	0	0	98	99	2	1	0	0	0	0	-1	0	0	0	0	1	0	0	1	6	0	0	0	0	0	0	0	0	0	0	0	0	6	0	0	0	6	5	0	0	0	0	0	0	5	0	0	5	-1	0	0	0	0	0	0	0	0	0	0	0	0	0	1	90	0	0	0	1	-1	-1	0	-1	-1	1	0	0	0	0	0	0	0	0	0	0	0	0	0	0	0	0	0	0	0	0	0	0	0	0	1
2	0	0	0	0	2	1	0	0	0	0	0	0	0	0	0	1	0	0	1	6	0	0	0	0	0	0	0	0	0	0	0	0	6	0	0	0	6	5	0	0	0	0	0	0	-1	0	0	5	-1	0	0	0	0	0	0	0	90	0	0	0	0	86	0	0	0	0	0	1	-1	0	0	0	-1	1	0	0	0	0	0	0	0	0	0	0	0	0	0	0	0	0	0	0	0	0	0	0	0	0	1
2	0	0	0	0	2	1	0	0	0	0	0	0	-1	0	0	0	0	0	1	6	0	0	0	0	0	0	0	0	0	0	99	0	6	0	0	0	6	5	0	0	99	5	0	0	0	0	0	5	-1	0	0	0	0	0	89	0	0	0	86	0	0	0	0	0	91	0	0	1	-1	0	0	0	-1	1	0	0	0	0	0	0	0	0	0	0	0	0	0	0	0	0	0	0	0	0	0	0	0	0	1
2	0	0	0	0	120	121	0	0	-1	0	0	0	-1	0	0	0	0	0	1	6	0	0	0	0	0	0	0	0	0	96	0	0	0	0	0	0	6	5	0	0	5	-1	0	0	0	0	0	5	-1	0	0	0	0	0	0	0	0	0	0	0	0	0	0	0	0	0	0	1	-1	0	0	0	-1	1	0	0	0	0	0	0	0	0	0	0	0	0	0	0	0	0	0	0	0	0	0	0	0	0	1
2	0	0	0	0	-13	-13	0	0	1	1	1	0	1	1	1	1	-1	-1	1	6	0	0	0	0	0	0	0	0	0	0	0	0	0	0	0	0	6	5	0	0	5	-1	0	0	0	0	0	5	-1	0	0	0	0	0	0	0	0	0	0	0	0	0	0	0	0	90	0	-32	0	0	0	0	-1	1	0	0	0	0	0	0	0	0	0	0	0	0	0	0	0	0	0	0	0	0	0	0	0	0	1
2	0	0	0	0	-13	-13	0	0	1	1	1	-1	1	1	1	1	-1	-1	1	6	-1	-1	-1	-1	-1	-1	99	-1	6	0	0	0	0	0	0	0	6	5	-1	-1	5	5	5	5	5	0	0	5	-1	-1	-1	-1	-1	-1	-1	-1	-1	-1	-1	-1	-1	-1	-1	0	0	0	0	-32	0	0	-1	0	-1	1	0	0	0	0	0	0	0	0	0	0	0	0	0	0	0	0	0	0	0	0	0	0	0	0	1
2	99	2	2	2	2	1	1	1	1	1	1	1	1	1	1	1	1	1	1	6	6	6	6	6	6	6	6	6	6	6	6	6	6	6	6	99	6	5	5	5	5	5	5	5	5	114	115	5	1	1	1	1	1	1	1	1	1	1	1	1	1	1	1	1	1	1	1	158	159	1	1	1	1	1	1	1	1	1	1	1	1	1	1	1	1	1	1	1	1	1	1	1	1	1	1	1	1	1	1
0	-1	0	0	0	0	0	0	0	0	0	0	0	0	0	0	0	0	0	0	0	0	0	0	0	0	0	0	0	0	0	0	0	0	0	0	-1	0	0	0	0	0	0	0	0	0	0	0	0	0	0	0	0	0	0	0	0	0	0	0	0	0	0	0	0	0	0	0	0	0	0	0	0	0	0	0	0	0	0	0	0	0	0	0	0	0	0	0	0	0	0	0	0	0	0	0	0	0	0	0
